Cone_LLMIME_MonsterCorrosiveSpray_Description	Belch forth putrid stench to inflict status ailments.<br>Reduces Physical Armour on targets in a cone by [1], and causes <font color='#EE82EE'>random status ailments</font> on targets hit.
Cone_LLMIME_MonsterCorrosiveSpray_DisplayName	Bad Breath
Cone_LLMIME_QuakeSlam_Description	Slam the ground, launching enemies within [1] up into the air.<br><font color='#fcd203'>Deals [2] initially, and [3] to [4] when they land (scales with launch height).</font><br><font color='#ff9600'>Each target hit creates another quake, launching enemies within [5] and dealing [6].</font>
Cone_LLMIME_QuakeSlam_DisplayName	Quake Slam
Jump_LLMIME_HiddenApproach_Description	Jump to a distant position and gain <font color='#a189ec'>Timely Retreat</font> for 2 turns, allowing you to return to your original position before jumping.
Jump_LLMIME_HiddenApproach_DisplayName	Hidden Approach
MultiStrike_LLMIME_MimeVault_Description	Appear behind an enemy and land a blow for [1] + [2].<br>Before initial damage is dealt, enemies receive <font color='#FF0000'>[3]% Dodge</font> and <font color='#FF0000'>[4]% Physical Resistance</font> from being <font color='#FF0000'>Flanked</font>.<br><font color='#FF00FF'>After flanking the enemy, your positions are <font color='#9a03ff'>Swapped</font>.</font><br><font color='#FF4500'>Grounded targets are immune to being Swapped.</font>
MultiStrike_LLMIME_MimeVault_DisplayName	Flank & Swap
Projectile_LLMIME_Decoy_Description	Jump to a distant position under a cloak of shadows, placing a decoy at your initial spot.<br>The decoy <font color='#DC143C'>taunts</font> nearby enemies at the end of your turn.<br><font color='#FFA07A'>Automatically disables mimicking by default.</font>
Projectile_LLMIME_Decoy_DisplayName	Decoy Ploy
Projectile_LLMIME_FinalWish_Description	Sacrifice your life to restore the lives of your party members.<br>Restores <font color='#FF0000'>50% Vitality</font>, and applies <font color='#97fbff'>Final Wish</font>, which makes the target <font color='#00FA9A'>resist death until the start of their turn, or they reach 1 Vitality.</font><br><font color='#FF0000'>Perish after casting.</font>
Projectile_LLMIME_FinalWish_DisplayName	Final Wish
Shout_LLMIME_BrawlerStance_Description	Toggles the use of the <font color='#FFD700'>Brawler's Fist</font>, an unarmed weapon that scales to your level and chosen attribute.<br><font color='#FF7F50'>Every few levels, the Brawler's Fist gains a new bonus.</font>
Shout_LLMIME_BrawlerStance_DisplayName	<font color='#FFD700'>Brawler Stance</font>
Shout_LLMIME_DisableMimicking_Description	<font color='#DC143C'>Prevents mimicking from automatically occuring.</font><br><font color='#188ede'>Using this skill again will cancel the effect.</font><br><font color='#FFA07A'>By default, mimicking is automatically disabled when Invisible.</font><br><font color='#FF00FF'>Mimicking Info:</font><br><font color='#FF69B4'>When in combat, Mimes mimic the skills, basic attacks, and item usage of the party, with the following restrictions:</font><br><font color='#DC143C'>Mimes cannot mimic skills that: require Source Points, are 'Special' Shout skills, directly summon creatures, and skills that are of the Rush/Jump type.</font><br><font color='#00FF7F'>When mimicking, Mimes copy the weapon(s) used.</font>
Shout_LLMIME_DisableMimicking_DisplayName	Disable Mimicking
Shout_LLMIME_EvasiveManeuver_Description	Dodging is increased by <font color='#FF00FF'>[1]%</font>|<font color='#EE82EE'>[2]%</font>|<font color='#D8BFD8'>[3]%</font> on turns <font color='#FF00FF'>1</font>|<font color='#EE82EE'>2</font>|<font color='#D8BFD8'>3</font><br>Movement speed is increased by [4]% on the first turn.<br><font color='#00FA9A'>While Counter Throw is active, you have a 90% chance to counter-attack for [5] when dodging.</font><br><font color='#FFD700'>Weapon Expansion</font><br><font color='#00FA9A'>When dodging an enemy, you have a 60% chance to counter-attack with a rock.</font>
Shout_LLMIME_EvasiveManeuver_DisplayName	Uncanny Dodge
Shout_LLMIME_Explosion_Description	Explode, dealing [1] to enemies in a large area around you. Creates fire surfaces.
Shout_LLMIME_Explosion_DisplayName	Explosion
Shout_LLMIME_ForcedEvolution_Description	Force yourself to evolve, transcending into a more powerful form.<br><font color='#FF0000'>Accelerating nature is strains the body, resulting in death after [1] turns.</font><br>Additionally grants a <font color='#00FF00'>[2]% Damage</font> and <font color='#00FF00'>[3]% Critical Chance</font> boost.
Shout_LLMIME_ForcedEvolution_DisplayName	Evolve
Shout_LLMIME_OpenMenu_Description	Focus on your inner self behind the mask, diving deep within your mind.<br><font color='#188ede'>Opens the Mimicry menu.</font>
Shout_LLMIME_OpenMenu_DisplayName	Inner Identity
Shout_LLMIME_ReturnToOwner_Description	Use the Mask of Mimicry's power to return to your leader.
Shout_LLMIME_ReturnToOwner_DisplayName	Return
Shout_LLMIME_SourceMimicking_Description	Surpass your limits, mimicking the next source skill used by a party member.<br><font color='#00FF7F'>While this skill is learned:</font><br><font color='#73f6ff'>Regenerate [1] SP every 60 seconds outside of combat, or 10 turns within combat.</font>
Shout_LLMIME_SourceMimicking_DisplayName	Mimic Source
Shout_LLMIME_TimelyRetreat_Description	Return to your original position before jumping with <font color='#a189ec'>Hidden Approach</font>.
Shout_LLMIME_TimelyRetreat_DisplayName	Timely Retreat
Storm_LLMIME_IncarnateLightning_Description	Summons a storm to rage upon the target area for 1 turn, dealing [1] per hit.
Storm_LLMIME_IncarnateLightning_DisplayName	Thunder Storm
Target_LLMIME_DisarmingBlow_Description	Deal [1] and disarm an enemy for 2 turns.<br>If the target is <font color='#FF0000'>Knocked Down</font>, steal a random amount of gold.<br><font color='#FFD700'>Weapon Expansion</font><br>When mugging the target, <font color='#FF00FF'>steal a throwable copy of their weapon</font> for 2 turns.
Target_LLMIME_DisarmingBlow_DisplayName	Disarming Blow
Target_LLMIME_EyeGouge_Description	Poke an enemy in the eyes, dealing [1] damage and blinding them for 1 turn.<br><font color='#EE82EE'>Blind bypasses armor.</font>
Target_LLMIME_EyeGouge_DisplayName	Eye Gouge
Target_LLMIME_KneeBreaker_Description	Deal [1] to target character, breaking their knee with a swift blow. When they try to move, they will take piercing damage.<br>If the target is <font color='#FF0000'>Disarmed</font>, apply <font color='#8A2BE2'>Bleeding</font> for 2 turns.
Target_LLMIME_KneeBreaker_DisplayName	Knee Breaker
Target_LLMIME_SealEvil_Description	Petrify the <font color='#40b606'>Undead</font>, dealing [1] and <font color='#a8a8a8'>Sealing</font> the target for 1 turn.<br><font color='#CD5C5C'>Removes Bleeding, Burning, and Poisoned.</font><br><font color='#97fbff'>Clears surfaces within a 2m range around the target.</font>
Target_LLMIME_SealEvil_DisplayName	Seal Evil
Target_LLMIME_SilencingStare_Description	Stare at an enemy with cold intensity.<br>If the target is <font color='#FF0000'>Crippled</font>, apply <font color='#8A2BE2'>Terrified</font> for 1 turn.
Target_LLMIME_SilencingStare_DisplayName	Silencing Stare
Target_LLMIME_VitalInfluence_Description	If <font color='#cd1f1f '>Constitution</font> is greater, gain <font color='#4197e2'>+[1]% Max Vitality (Strengthened Vitals)</font> and inflict <font color='#FF0000'>[2]% Max Vitality (Weakened Vitals)</font> on target for [3] turns.<br><font color='#FF0000'>Weakened Vitals</font> additionally deals [4] each turn.
Target_LLMIME_VitalInfluence_DisplayName	Vital Influence
Target_LLMIME_Wish_Description	Sacrifice <font color='#FF0000'>50% Vitality</font> to <font color='#97fbff'>restore twice as much</font> to an ally.
Target_LLMIME_Wish_DisplayName	Wish
Target_LLMIME_FrogAttack_DisplayName	Frog Attack
Target_LLMIME_FrogAttack_Description	A pitifully weak attack that deals [1].
Target_LLMIME_PerfectDoppelganger_DisplayName	<font color='#aa5bfb'>Perfect Doppelganger</font>
Target_LLMIME_PerfectDoppelganger_Description	Mimic a target completely, becoming a perfect copy for 2 turns.<br><font color='#188EDE'>Doppelgangers copy the skills, equipment, stats, and abilities of the target.</font>
Target_LLMIME_Mask_Unholy_DisplayName	<font color='#aa5bfb'>Unholy Darkness</font>
Target_LLMIME_Mask_Unholy_Description	Release the dark energy within your mask, dealing [1] + [3] in a [2] radius.<br><font color='#7b33f3'>Enemies who die explode in a cursed cloud of darkness.</font><br><font color='#ea3e5f'>Initial damage scales with your maximum vitality.</font><br><font color='#11D77A' size='18'>Shadow Damage bypasses armor and cannot be resisted.</font>
Target_LLMIME_SetFacingDirection_DisplayName	<font color='#a1f398'>Set Facing</font>
Target_LLMIME_SetFacingDirection_Description	Set the direction to look when your turn ends.<br><font color='#eb64ff'>Tip: Mimicking factors in the mime's look direction, so facing the right way is important for setting up mimicked actions.</font><br><font color='#ff3838'>Cleared when your turn starts.</font>
Cone_LLMIME_WaterSpit_DisplayName	Salty Water
Cone_LLMIME_WaterSpit_Description	Spray targets in a cone with water, dealing [1], setting Wet, and dousing surfaces.